6 B 5 E
WWWWWW
W___PW
WGUP_W
W____W
W__P_W
WWWWWW
